00,01,01,01,01,01,01,01,01,01,01,01,01,02,03,01,01,01,01,01,01,01,01,01,01,01,01,04
05,06,06,06,06,06,06,06,06,06,06,06,06,07,08,06,06,06,06,06,06,06,06,06,06,06,06,09
05,06,10,11,11,12,06,10,11,11,11,12,06,07,08,06,10,11,11,11,12,06,10,11,11,12,06,09
05,06,07,06,06,08,06,07,06,06,06,08,06,07,08,06,07,06,06,06,08,06,07,06,06,08,06,09
05,06,13,14,14,15,06,13,14,14,14,15,06,13,15,06,13,14,14,14,15,06,13,14,14,15,06,09
05,06,06,06,06,06,06,06,06,06,06,06,06,06,06,06,06,06,06,06,06,06,06,06,06,06,06,09
05,06,10,11,11,12,06,10,12,06,10,11,11,11,11,11,11,12,06,10,12,06,10,11,11,12,06,09
05,06,13,14,14,15,06,07,08,06,13,14,14,16,17,14,14,15,06,07,08,06,13,14,14,15,06,09
05,06,06,06,06,06,06,07,08,06,06,06,06,07,08,06,06,06,06,07,08,06,06,06,06,06,06,09
18,19,19,19,19,12,06,07,20,11,11,12,06,07,08,06,10,11,11,21,08,06,10,19,19,19,19,22
06,06,06,06,06,05,06,07,17,14,14,15,06,13,15,06,13,14,14,16,08,06,09,06,06,06,06,06
06,06,06,06,06,05,06,07,08,06,06,06,06,06,06,06,06,06,06,07,08,06,09,06,06,06,06,06
06,06,06,06,06,05,06,07,08,06,23,19,24,06,06,25,19,26,06,07,08,06,09,06,06,06,06,06
01,01,01,01,01,15,06,13,15,06,09,06,06,06,06,06,06,05,06,13,15,06,13,01,01,01,01,01
06,06,06,06,06,06,06,06,06,06,09,06,06,06,06,06,06,05,06,06,06,06,06,06,06,06,06,06
19,19,19,19,19,12,06,10,12,06,09,06,06,06,06,06,06,05,06,10,12,06,10,19,19,19,19,19
06,06,06,06,06,05,06,07,08,06,27,01,01,01,01,01,01,28,06,07,08,06,09,06,06,06,06,06
06,06,06,06,06,05,06,07,08,06,06,06,06,06,06,06,06,06,06,07,08,06,09,06,06,06,06,06
06,06,06,06,06,05,06,07,08,06,10,11,11,11,11,11,11,12,06,07,08,06,09,06,06,06,06,06
00,01,01,01,01,15,06,13,15,06,13,14,14,16,17,14,14,15,06,13,15,06,13,01,01,01,01,29
05,06,06,06,06,06,06,06,06,06,06,06,06,07,08,06,06,06,06,06,06,06,06,06,06,06,06,09
05,06,10,11,11,12,06,10,11,11,11,12,06,07,08,06,10,11,11,11,12,06,10,11,11,12,06,09
05,06,13,14,16,08,06,13,14,14,14,15,06,13,15,06,13,14,14,14,15,06,07,17,14,15,06,09
05,06,06,06,07,08,06,06,06,06,06,06,06,06,06,06,06,06,06,06,06,06,07,08,06,06,06,09
30,11,12,06,07,08,06,10,12,06,10,11,11,11,11,11,11,12,06,10,12,06,07,08,06,10,11,31
32,14,15,06,13,15,06,07,08,06,13,14,14,16,17,14,14,15,06,07,08,06,13,15,06,13,14,33
05,06,06,06,06,06,06,07,08,06,06,06,06,07,08,06,06,06,06,07,08,06,06,06,06,06,06,09
05,06,10,11,11,11,11,21,20,11,11,12,06,07,08,06,10,11,11,21,20,11,11,11,11,12,06,09
05,06,13,14,14,14,14,14,14,14,14,15,06,13,15,06,13,14,14,14,14,14,14,14,14,15,06,09
05,06,06,06,06,06,06,06,06,06,06,06,06,06,06,06,06,06,06,06,06,06,06,06,06,06,06,09
18,19,19,19,19,19,19,19,19,19,19,19,19,19,19,19,19,19,19,19,19,19,19,19,19,19,19,34